#####################
#S#                 #
# ################# #
#         #         #
######### # ####### #
#       # # # #   # #
# ##### # # # # # # #
#   #   # # #   # # #
### # # # # ##### # #
# # # # #   #     # #
# # # # ##### ### # #
#   # # #     # # # #
# ### # ### ### # # #
# #   #     #     # #
# # ########### ### #
# #     #     #   # #
# ##### # ### ##### #
# #   # # #   #     #
# ### # # # ### #####
#     #   #        E#
#####################
